[
  {
    "BG-Music": "assets/audio/bg-music/Kenny-Rogers-Gambler",
    "map": [
      [7, 5, 5, 5, 5, 5, 5, 5, 5, 17, 5, 5, 5, 5, 5, 5, 5, 5, 8],
      [6, 1, 1, 1, 1, 1, 1, 1, 1, 6, 1, 1, 1, 1, 1, 1, 1, 1, 6],
      [6, 4, 7, 8, 1, 7, 5, 8, 1, 6, 1, 7, 5, 8, 1, 7, 8, 4, 6],
      [6, 1, 9, 10, 1, 9, 5, 10, 1, 13, 1, 9, 5, 10, 1, 9, 10, 1, 6],
      [6, 1, 1, 1, 1, 1, 1, 1, 1, 1, 1, 1, 1, 1, 1, 1, 1, 1, 6],
      [6, 1, 14, 12, 1, 11, 1, 14, 5, 17, 5, 12, 1, 11, 1, 14, 12, 1, 6],
      [6, 1, 1, 1, 1, 6, 1, 1, 1, 6, 1, 1, 1, 6, 1, 1, 1, 1, 6],
      [9, 5, 5, 8, 1, 16, 5, 12, 1, 13, 1, 14, 5, 18, 1, 7, 5, 5, 10],
      [2, 2, 2, 6, 1, 6, 1, 1, 1, 1, 1, 1, 1, 6, 1, 6, 2, 2, 2],
      [5, 5, 5, 10, 1, 13, 1, 7, 12, 3, 14, 8, 1, 13, 1, 9, 5, 5, 5],
      [2, 2, 2, 2, 1, 1, 1, 6, 3, 3, 3, 6, 1, 1, 1, 2, 2, 2, 2],
      [5, 5, 5, 8, 1, 11, 1, 9, 5, 5, 5, 10, 1, 11, 1, 7, 5, 5, 5],
      [2, 2, 2, 6, 1, 6, 1, 1, 1, 2, 1, 1, 1, 6, 1, 6, 2, 2, 2],
      [7, 5, 5, 10, 1, 13, 1, 14, 5, 17, 5, 12, 1, 13, 1, 9, 5, 5, 8],
      [6, 1, 1, 1, 1, 1, 1, 1, 1, 6, 1, 1, 1, 1, 1, 1, 1, 1, 6],
      [6, 1, 14, 8, 1, 14, 5, 12, 1, 13, 1, 14, 5, 12, 1, 7, 12, 1, 6],
      [6, 4, 1, 6, 1, 1, 1, 1, 1, 1, 1, 1, 1, 1, 1, 6, 1, 4, 6],
      [16, 12, 1, 13, 1, 11, 1, 14, 5, 17, 5, 12, 1, 11, 1, 13, 1, 14, 18],
      [6, 1, 1, 1, 1, 6, 1, 1, 1, 6, 1, 1, 1, 6, 1, 1, 1, 1, 6],
      [6, 1, 14, 5, 5, 15, 5, 12, 1, 13, 1, 14, 5, 15, 5, 5, 12, 1, 6],
      [6, 1, 1, 1, 1, 1, 1, 1, 1, 1, 1, 1, 1, 1, 1, 1, 1, 1, 6],
      [9, 5, 5, 5, 5, 5, 5, 5, 5, 5, 5, 5, 5, 5, 5, 5, 5, 5, 10]
    ],
    "ghosts": []
  },
  {
    "BG-Music": "assets/audio/bg-music/Gwen-Stefani-Rich-Girl",
    "map": [
      [0, 0, 0, 0, 0, 0, 0, 0, 0, 0, 0, 0, 0, 0, 0, 0, 0, 0, 0],
      [0, 0, 0, 0, 0, 0, 0, 0, 0, 0, 0, 0, 0, 0, 0, 0, 0, 0, 0],
      [0, 0, 0, 0, 0, 0, 0, 0, 0, 0, 0, 0, 0, 0, 0, 0, 0, 0, 0],
      [0, 0, 0, 0, 0, 0, 0, 0, 0, 0, 0, 0, 0, 0, 0, 0, 0, 0, 0],
      [0, 0, 0, 0, 0, 0, 0, 0, 0, 0, 0, 0, 0, 0, 0, 0, 0, 0, 0],
      [0, 0, 0, 0, 0, 0, 0, 0, 0, 0, 0, 0, 0, 0, 0, 0, 0, 0, 0],
      [0, 0, 0, 0, 0, 0, 0, 0, 0, 0, 0, 0, 0, 0, 0, 0, 0, 0, 0],
      [7, 5, 5, 5, 5, 5, 5, 5, 5, 5, 5, 5, 5, 5, 5, 5, 5, 5, 8],
      [6, 2, 2, 2, 2, 2, 2, 2, 2, 2, 2, 2, 2, 2, 2, 2, 2, 2, 6],
      [6, 2, 2, 2, 2, 2, 2, 2, 2, 2, 2, 2, 2, 2, 2, 2, 2, 2, 6],
      [6, 2, 2, 2, 2, 2, 2, 2, 2, 4, 2, 2, 2, 2, 2, 2, 2, 2, 6],
      [6, 2, 2, 2, 2, 2, 2, 2, 2, 2, 2, 2, 2, 2, 2, 2, 2, 2, 6],
      [6, 2, 2, 2, 2, 2, 2, 2, 2, 2, 2, 2, 2, 2, 2, 2, 2, 2, 6],
      [9, 5, 5, 5, 5, 5, 5, 5, 5, 5, 5, 5, 5, 5, 5, 5, 5, 5, 10],
      [0, 0, 0, 0, 0, 0, 0, 0, 0, 0, 0, 0, 0, 0, 0, 0, 0, 0, 0],
      [0, 0, 0, 0, 0, 0, 0, 0, 0, 0, 0, 0, 0, 0, 0, 0, 0, 0, 0],
      [0, 0, 0, 0, 0, 0, 0, 0, 0, 0, 0, 0, 0, 0, 0, 0, 0, 0, 0],
      [0, 0, 0, 0, 0, 0, 0, 0, 0, 0, 0, 0, 0, 0, 0, 0, 0, 0, 0],
      [0, 0, 0, 0, 0, 0, 0, 0, 0, 0, 0, 0, 0, 0, 0, 0, 0, 0, 0],
      [0, 0, 0, 0, 0, 0, 0, 0, 0, 0, 0, 0, 0, 0, 0, 0, 0, 0, 0],
      [0, 0, 0, 0, 0, 0, 0, 0, 0, 0, 0, 0, 0, 0, 0, 0, 0, 0, 0],
      [0, 0, 0, 0, 0, 0, 0, 0, 0, 0, 0, 0, 0, 0, 0, 0, 0, 0, 0]
    ],
    "ghosts": [
      {
        "img": "./assets/ghosts/1/ghost.png"
      }
    ],
    "box": {
      "msg": "David Thomson\nNet Worth: $52.9 billion\nMajor stakeholder of Thomson Reuters media company\nOffence: Selling tech to ICE to help spy on/ deport migrants\nStrengths: Grandaddy’s money\nWeakness: Willing to drop $70 million on a Baroque painting",
      "img": "./assets/ghosts/1/thomson.gif"
    }
  },
  {
    "BG-Music": "assets/audio/bg-music/Wu-Tang-CREAM",
    "map": [
      [7, 5, 5, 5, 5, 5, 5, 5, 5, 1, 5, 5, 5, 5, 5, 5, 5, 5, 8],
      [6, 1, 1, 1, 1, 1, 1, 1, 1, 1, 1, 1, 1, 1, 1, 1, 1, 1, 6],
      [6, 4, 7, 8, 1, 7, 5, 8, 1, 1, 1, 7, 5, 8, 1, 7, 8, 4, 6],
      [6, 1, 9, 10, 1, 9, 5, 10, 1, 13, 1, 9, 5, 10, 1, 9, 10, 1, 6],
      [6, 1, 1, 1, 1, 1, 1, 1, 1, 1, 1, 1, 1, 1, 1, 1, 1, 1, 6],
      [6, 1, 14, 12, 1, 11, 1, 14, 5, 17, 5, 12, 1, 11, 1, 14, 12, 1, 6],
      [6, 1, 1, 1, 1, 6, 1, 1, 1, 6, 1, 1, 1, 6, 1, 1, 1, 1, 6],
      [9, 5, 5, 8, 1, 16, 5, 12, 1, 13, 1, 14, 5, 18, 1, 7, 5, 5, 10],
      [2, 2, 2, 6, 1, 6, 1, 1, 1, 1, 1, 1, 1, 6, 1, 6, 2, 2, 2],
      [5, 5, 5, 10, 1, 13, 1, 7, 12, 3, 14, 8, 1, 13, 1, 9, 5, 5, 5],
      [2, 2, 2, 2, 1, 1, 1, 6, 3, 3, 3, 6, 1, 1, 1, 2, 2, 2, 2],
      [5, 5, 5, 8, 1, 11, 1, 9, 5, 5, 5, 10, 1, 11, 1, 7, 5, 5, 5],
      [2, 2, 2, 6, 1, 6, 1, 1, 1, 2, 1, 1, 1, 6, 1, 6, 2, 2, 2],
      [7, 5, 5, 10, 1, 13, 1, 14, 5, 17, 5, 12, 1, 13, 1, 9, 5, 5, 8],
      [6, 1, 1, 1, 1, 1, 1, 1, 1, 6, 1, 1, 1, 1, 1, 1, 1, 1, 6],
      [6, 1, 14, 8, 1, 14, 5, 12, 1, 13, 1, 14, 5, 12, 1, 7, 12, 1, 6],
      [6, 4, 1, 6, 1, 1, 1, 1, 1, 1, 1, 1, 1, 1, 1, 6, 1, 4, 6],
      [16, 12, 1, 13, 1, 11, 1, 14, 5, 17, 5, 12, 1, 11, 1, 13, 1, 14, 18],
      [6, 1, 1, 1, 1, 6, 1, 1, 1, 6, 1, 1, 1, 6, 1, 1, 1, 1, 6],
      [6, 1, 14, 5, 5, 15, 5, 12, 1, 13, 1, 14, 5, 15, 5, 5, 12, 1, 6],
      [6, 1, 1, 1, 1, 1, 1, 1, 1, 1, 1, 1, 1, 1, 1, 1, 1, 1, 6],
      [9, 5, 5, 5, 5, 5, 5, 5, 5, 1, 5, 5, 5, 5, 5, 5, 5, 5, 10]
    ],
    "ghosts": [
      {
        "img": ""
      },
      {
        "img": "./assets/ghosts/1/ghost.png"
      }
    ],
    "box": {
      "msg": "Galen Weston Jr\nNet Worth: $13.4 billion\nChairman and CEO of George Weston Limited\nOffence: Colluding with competitors to raise bread prices\nStrengths: Inheriting a retail empire\nWeakness: Offering brazenly low bonuses to workers",
      "img": "./assets/ghosts/2/weston jr.gif"
    }
  },
  {
    "BG-Music": "assets/audio/bg-music/Destinys-Child-bills-bills-bills",
    "map": [
      [7, 5, 5, 5, 5, 5, 5, 5, 5, 17, 5, 5, 5, 5, 5, 5, 5, 5, 8],
      [6, 1, 1, 1, 1, 1, 1, 1, 1, 6, 1, 1, 1, 1, 1, 1, 1, 1, 6],
      [6, 4, 7, 8, 1, 7, 5, 8, 1, 6, 1, 7, 5, 8, 1, 7, 8, 4, 6],
      [6, 1, 9, 10, 1, 9, 5, 10, 1, 13, 1, 9, 5, 10, 1, 9, 10, 1, 6],
      [6, 1, 1, 1, 1, 1, 1, 1, 1, 1, 1, 1, 1, 1, 1, 1, 1, 1, 6],
      [6, 1, 14, 12, 1, 11, 1, 14, 5, 17, 5, 12, 1, 11, 1, 14, 12, 1, 6],
      [6, 1, 1, 1, 1, 6, 1, 1, 1, 6, 1, 1, 1, 6, 1, 1, 1, 1, 6],
      [9, 5, 5, 8, 1, 16, 5, 12, 1, 13, 1, 14, 5, 18, 1, 7, 5, 5, 10],
      [2, 2, 2, 6, 1, 6, 1, 1, 1, 1, 1, 1, 1, 6, 1, 6, 2, 2, 2],
      [5, 5, 5, 10, 1, 13, 1, 7, 12, 3, 14, 8, 1, 13, 1, 9, 5, 5, 5],
      [2, 2, 2, 2, 1, 1, 1, 6, 3, 3, 3, 6, 1, 1, 1, 2, 2, 2, 2],
      [5, 5, 5, 8, 1, 11, 1, 9, 5, 5, 5, 10, 1, 11, 1, 7, 5, 5, 5],
      [2, 2, 2, 6, 1, 6, 1, 1, 1, 2, 1, 1, 1, 6, 1, 6, 2, 2, 2],
      [7, 5, 5, 10, 1, 13, 1, 14, 5, 17, 5, 12, 1, 13, 1, 9, 5, 5, 8],
      [6, 1, 1, 1, 1, 1, 1, 1, 1, 6, 1, 1, 1, 1, 1, 1, 1, 1, 6],
      [6, 1, 14, 8, 1, 14, 5, 12, 1, 13, 1, 14, 5, 12, 1, 7, 12, 1, 6],
      [6, 4, 1, 6, 1, 1, 1, 1, 1, 1, 1, 1, 1, 1, 1, 6, 1, 4, 6],
      [16, 12, 1, 13, 1, 11, 1, 14, 5, 17, 5, 12, 1, 11, 1, 13, 1, 14, 18],
      [6, 1, 1, 1, 1, 6, 1, 1, 1, 6, 1, 1, 1, 6, 1, 1, 1, 1, 6],
      [6, 1, 14, 5, 5, 15, 5, 12, 1, 13, 1, 14, 5, 15, 5, 5, 12, 1, 6],
      [6, 1, 1, 1, 1, 1, 1, 1, 1, 1, 1, 1, 1, 1, 1, 1, 1, 1, 6],
      [9, 5, 5, 5, 5, 5, 5, 5, 5, 5, 5, 5, 5, 5, 5, 5, 5, 5, 10]
    ],
    "ghosts": [
      {
        "img": ""
      },
      {
        "img": "./assets/ghosts/1/ghost.png"
      }
    ]
  },
  {
    "BG-Music": "assets/audio/bg-music/Barrett-Strong-Money",
    "map": [
      [7, 5, 5, 5, 5, 5, 5, 5, 5, 17, 5, 5, 5, 5, 5, 5, 5, 5, 8],
      [6, 1, 1, 1, 1, 1, 1, 1, 1, 6, 1, 1, 1, 1, 1, 1, 1, 1, 6],
      [6, 4, 7, 8, 1, 7, 5, 8, 1, 6, 1, 7, 5, 8, 1, 7, 8, 4, 6],
      [6, 1, 9, 10, 1, 9, 5, 10, 1, 13, 1, 9, 5, 10, 1, 9, 10, 1, 6],
      [6, 1, 1, 1, 1, 1, 1, 1, 1, 1, 1, 1, 1, 1, 1, 1, 1, 1, 6],
      [6, 1, 14, 12, 1, 11, 1, 14, 5, 17, 5, 12, 1, 11, 1, 14, 12, 1, 6],
      [6, 1, 1, 1, 1, 6, 1, 1, 1, 6, 1, 1, 1, 6, 1, 1, 1, 1, 6],
      [9, 5, 5, 8, 1, 16, 5, 12, 1, 13, 1, 14, 5, 18, 1, 7, 5, 5, 10],
      [2, 2, 2, 6, 1, 6, 1, 1, 1, 1, 1, 1, 1, 6, 1, 6, 2, 2, 2],
      [5, 5, 5, 10, 1, 13, 1, 7, 12, 3, 14, 8, 1, 13, 1, 9, 5, 5, 5],
      [2, 2, 2, 2, 1, 1, 1, 6, 3, 3, 3, 6, 1, 1, 1, 2, 2, 2, 2],
      [5, 5, 5, 8, 1, 11, 1, 9, 5, 5, 5, 10, 1, 11, 1, 7, 5, 5, 5],
      [2, 2, 2, 6, 1, 6, 1, 1, 1, 2, 1, 1, 1, 6, 1, 6, 2, 2, 2],
      [7, 5, 5, 10, 1, 13, 1, 14, 5, 17, 5, 12, 1, 13, 1, 9, 5, 5, 8],
      [6, 1, 1, 1, 1, 1, 1, 1, 1, 6, 1, 1, 1, 1, 1, 1, 1, 1, 6],
      [6, 1, 14, 8, 1, 14, 5, 12, 1, 13, 1, 14, 5, 12, 1, 7, 12, 1, 6],
      [6, 4, 1, 6, 1, 1, 1, 1, 1, 1, 1, 1, 1, 1, 1, 6, 1, 4, 6],
      [16, 12, 1, 13, 1, 11, 1, 14, 5, 17, 5, 12, 1, 11, 1, 13, 1, 14, 18],
      [6, 1, 1, 1, 1, 6, 1, 1, 1, 6, 1, 1, 1, 6, 1, 1, 1, 1, 6],
      [6, 1, 14, 5, 5, 15, 5, 12, 1, 13, 1, 14, 5, 15, 5, 5, 12, 1, 6],
      [6, 1, 1, 1, 1, 1, 1, 1, 1, 1, 1, 1, 1, 1, 1, 1, 1, 1, 6],
      [9, 5, 5, 5, 5, 5, 5, 5, 5, 5, 5, 5, 5, 5, 5, 5, 5, 5, 10]
    ],
    "ghosts": [
      {
        "img": ""
      },
      {
        "img": "./assets/ghosts/1/ghost.png"
      }
    ]
  },
  {
    "BG-Music": "assets/audio/bg-music/Madonna-Material-Girl",
    "map": [
      [7, 5, 5, 5, 5, 5, 5, 5, 5, 17, 5, 5, 5, 5, 5, 5, 5, 5, 8],
      [6, 1, 1, 1, 1, 1, 1, 1, 1, 6, 1, 1, 1, 1, 1, 1, 1, 1, 6],
      [6, 4, 7, 8, 1, 7, 5, 8, 1, 6, 1, 7, 5, 8, 1, 7, 8, 4, 6],
      [6, 1, 9, 10, 1, 9, 5, 10, 1, 13, 1, 9, 5, 10, 1, 9, 10, 1, 6],
      [6, 1, 1, 1, 1, 1, 1, 1, 1, 1, 1, 1, 1, 1, 1, 1, 1, 1, 6],
      [6, 1, 14, 12, 1, 11, 1, 14, 5, 17, 5, 12, 1, 11, 1, 14, 12, 1, 6],
      [6, 1, 1, 1, 1, 6, 1, 1, 1, 6, 1, 1, 1, 6, 1, 1, 1, 1, 6],
      [9, 5, 5, 8, 1, 16, 5, 12, 1, 13, 1, 14, 5, 18, 1, 7, 5, 5, 10],
      [2, 2, 2, 6, 1, 6, 1, 1, 1, 1, 1, 1, 1, 6, 1, 6, 2, 2, 2],
      [5, 5, 5, 10, 1, 13, 1, 7, 12, 3, 14, 8, 1, 13, 1, 9, 5, 5, 5],
      [2, 2, 2, 2, 1, 1, 1, 6, 3, 3, 3, 6, 1, 1, 1, 2, 2, 2, 2],
      [5, 5, 5, 8, 1, 11, 1, 9, 5, 5, 5, 10, 1, 11, 1, 7, 5, 5, 5],
      [2, 2, 2, 6, 1, 6, 1, 1, 1, 2, 1, 1, 1, 6, 1, 6, 2, 2, 2],
      [7, 5, 5, 10, 1, 13, 1, 14, 5, 17, 5, 12, 1, 13, 1, 9, 5, 5, 8],
      [6, 1, 1, 1, 1, 1, 1, 1, 1, 6, 1, 1, 1, 1, 1, 1, 1, 1, 6],
      [6, 1, 14, 8, 1, 14, 5, 12, 1, 13, 1, 14, 5, 12, 1, 7, 12, 1, 6],
      [6, 4, 1, 6, 1, 1, 1, 1, 1, 1, 1, 1, 1, 1, 1, 6, 1, 4, 6],
      [16, 12, 1, 13, 1, 11, 1, 14, 5, 17, 5, 12, 1, 11, 1, 13, 1, 14, 18],
      [6, 1, 1, 1, 1, 6, 1, 1, 1, 6, 1, 1, 1, 6, 1, 1, 1, 1, 6],
      [6, 1, 14, 5, 5, 15, 5, 12, 1, 13, 1, 14, 5, 15, 5, 5, 12, 1, 6],
      [6, 1, 1, 1, 1, 1, 1, 1, 1, 1, 1, 1, 1, 1, 1, 1, 1, 1, 6],
      [9, 5, 5, 5, 5, 5, 5, 5, 5, 5, 5, 5, 5, 5, 5, 5, 5, 5, 10]
    ],
    "ghosts": [
      {
        "img": ""
      },
      {
        "img": "./assets/ghosts/1/ghost.png"
      }
    ]
  },
  {
    "BG-Music": "assets/audio/bg-music/Pink-Floyd-Money",
    "map": [
      [7, 5, 5, 5, 5, 5, 5, 5, 5, 17, 5, 5, 5, 5, 5, 5, 5, 5, 8],
      [6, 1, 1, 1, 1, 1, 1, 1, 1, 6, 1, 1, 1, 1, 1, 1, 1, 1, 6],
      [6, 4, 7, 8, 1, 7, 5, 8, 1, 6, 1, 7, 5, 8, 1, 7, 8, 4, 6],
      [6, 1, 9, 10, 1, 9, 5, 10, 1, 13, 1, 9, 5, 10, 1, 9, 10, 1, 6],
      [6, 1, 1, 1, 1, 1, 1, 1, 1, 1, 1, 1, 1, 1, 1, 1, 1, 1, 6],
      [6, 1, 14, 12, 1, 11, 1, 14, 5, 17, 5, 12, 1, 11, 1, 14, 12, 1, 6],
      [6, 1, 1, 1, 1, 6, 1, 1, 1, 6, 1, 1, 1, 6, 1, 1, 1, 1, 6],
      [9, 5, 5, 8, 1, 16, 5, 12, 1, 13, 1, 14, 5, 18, 1, 7, 5, 5, 10],
      [2, 2, 2, 6, 1, 6, 1, 1, 1, 1, 1, 1, 1, 6, 1, 6, 2, 2, 2],
      [5, 5, 5, 10, 1, 13, 1, 7, 12, 3, 14, 8, 1, 13, 1, 9, 5, 5, 5],
      [2, 2, 2, 2, 1, 1, 1, 6, 3, 3, 3, 6, 1, 1, 1, 2, 2, 2, 2],
      [5, 5, 5, 8, 1, 11, 1, 9, 5, 5, 5, 10, 1, 11, 1, 7, 5, 5, 5],
      [2, 2, 2, 6, 1, 6, 1, 1, 1, 2, 1, 1, 1, 6, 1, 6, 2, 2, 2],
      [7, 5, 5, 10, 1, 13, 1, 14, 5, 17, 5, 12, 1, 13, 1, 9, 5, 5, 8],
      [6, 1, 1, 1, 1, 1, 1, 1, 1, 6, 1, 1, 1, 1, 1, 1, 1, 1, 6],
      [6, 1, 14, 8, 1, 14, 5, 12, 1, 13, 1, 14, 5, 12, 1, 7, 12, 1, 6],
      [6, 4, 1, 6, 1, 1, 1, 1, 1, 1, 1, 1, 1, 1, 1, 6, 1, 4, 6],
      [16, 12, 1, 13, 1, 11, 1, 14, 5, 17, 5, 12, 1, 11, 1, 13, 1, 14, 18],
      [6, 1, 1, 1, 1, 6, 1, 1, 1, 6, 1, 1, 1, 6, 1, 1, 1, 1, 6],
      [6, 1, 14, 5, 5, 15, 5, 12, 1, 13, 1, 14, 5, 15, 5, 5, 12, 1, 6],
      [6, 1, 1, 1, 1, 1, 1, 1, 1, 1, 1, 1, 1, 1, 1, 1, 1, 1, 6],
      [9, 5, 5, 5, 5, 5, 5, 5, 5, 5, 5, 5, 5, 5, 5, 5, 5, 5, 10]
    ],
    "ghosts": [
      {
        "img": ""
      },
      {
        "img": "./assets/ghosts/1/ghost.png"
      }
    ]
  },
  {
    "BG-Music": "assets/audio/bg-music/ABBA-Money",
    "map": [
      [7, 5, 5, 5, 5, 5, 5, 5, 5, 17, 5, 5, 5, 5, 5, 5, 5, 5, 8],
      [6, 1, 1, 1, 1, 1, 1, 1, 1, 6, 1, 1, 1, 1, 1, 1, 1, 1, 6],
      [6, 4, 7, 8, 1, 7, 5, 8, 1, 6, 1, 7, 5, 8, 1, 7, 8, 4, 6],
      [6, 1, 9, 10, 1, 9, 5, 10, 1, 13, 1, 9, 5, 10, 1, 9, 10, 1, 6],
      [6, 1, 1, 1, 1, 1, 1, 1, 1, 1, 1, 1, 1, 1, 1, 1, 1, 1, 6],
      [6, 1, 14, 12, 1, 11, 1, 14, 5, 17, 5, 12, 1, 11, 1, 14, 12, 1, 6],
      [6, 1, 1, 1, 1, 6, 1, 1, 1, 6, 1, 1, 1, 6, 1, 1, 1, 1, 6],
      [9, 5, 5, 8, 1, 16, 5, 12, 1, 13, 1, 14, 5, 18, 1, 7, 5, 5, 10],
      [2, 2, 2, 6, 1, 6, 1, 1, 1, 1, 1, 1, 1, 6, 1, 6, 2, 2, 2],
      [5, 5, 5, 10, 1, 13, 1, 7, 12, 3, 14, 8, 1, 13, 1, 9, 5, 5, 5],
      [2, 2, 2, 2, 1, 1, 1, 6, 3, 3, 3, 6, 1, 1, 1, 2, 2, 2, 2],
      [5, 5, 5, 8, 1, 11, 1, 9, 5, 5, 5, 10, 1, 11, 1, 7, 5, 5, 5],
      [2, 2, 2, 6, 1, 6, 1, 1, 1, 2, 1, 1, 1, 6, 1, 6, 2, 2, 2],
      [7, 5, 5, 10, 1, 13, 1, 14, 5, 17, 5, 12, 1, 13, 1, 9, 5, 5, 8],
      [6, 1, 1, 1, 1, 1, 1, 1, 1, 6, 1, 1, 1, 1, 1, 1, 1, 1, 6],
      [6, 1, 14, 8, 1, 14, 5, 12, 1, 13, 1, 14, 5, 12, 1, 7, 12, 1, 6],
      [6, 4, 1, 6, 1, 1, 1, 1, 1, 1, 1, 1, 1, 1, 1, 6, 1, 4, 6],
      [16, 12, 1, 13, 1, 11, 1, 14, 5, 17, 5, 12, 1, 11, 1, 13, 1, 14, 18],
      [6, 1, 1, 1, 1, 6, 1, 1, 1, 6, 1, 1, 1, 6, 1, 1, 1, 1, 6],
      [6, 1, 14, 5, 5, 15, 5, 12, 1, 13, 1, 14, 5, 15, 5, 5, 12, 1, 6],
      [6, 1, 1, 1, 1, 1, 1, 1, 1, 1, 1, 1, 1, 1, 1, 1, 1, 1, 6],
      [9, 5, 5, 5, 5, 5, 5, 5, 5, 5, 5, 5, 5, 5, 5, 5, 5, 5, 10]
    ],
    "ghosts": [
      {
        "img": ""
      },
      {
        "img": "./assets/ghosts/1/ghost.png"
      }
    ]
  },
  {
    "BG-Music": "assets/audio/bg-music/ACDC-Money-Talks",
    "map": [
      [7, 5, 5, 5, 5, 5, 5, 5, 5, 17, 5, 5, 5, 5, 5, 5, 5, 5, 8],
      [6, 1, 1, 1, 1, 1, 1, 1, 1, 6, 1, 1, 1, 1, 1, 1, 1, 1, 6],
      [6, 4, 7, 8, 1, 7, 5, 8, 1, 6, 1, 7, 5, 8, 1, 7, 8, 4, 6],
      [6, 1, 9, 10, 1, 9, 5, 10, 1, 13, 1, 9, 5, 10, 1, 9, 10, 1, 6],
      [6, 1, 1, 1, 1, 1, 1, 1, 1, 1, 1, 1, 1, 1, 1, 1, 1, 1, 6],
      [6, 1, 14, 12, 1, 11, 1, 14, 5, 17, 5, 12, 1, 11, 1, 14, 12, 1, 6],
      [6, 1, 1, 1, 1, 6, 1, 1, 1, 6, 1, 1, 1, 6, 1, 1, 1, 1, 6],
      [9, 5, 5, 8, 1, 16, 5, 12, 1, 13, 1, 14, 5, 18, 1, 7, 5, 5, 10],
      [2, 2, 2, 6, 1, 6, 1, 1, 1, 1, 1, 1, 1, 6, 1, 6, 2, 2, 2],
      [5, 5, 5, 10, 1, 13, 1, 7, 12, 3, 14, 8, 1, 13, 1, 9, 5, 5, 5],
      [2, 2, 2, 2, 1, 1, 1, 6, 3, 3, 3, 6, 1, 1, 1, 2, 2, 2, 2],
      [5, 5, 5, 8, 1, 11, 1, 9, 5, 5, 5, 10, 1, 11, 1, 7, 5, 5, 5],
      [2, 2, 2, 6, 1, 6, 1, 1, 1, 2, 1, 1, 1, 6, 1, 6, 2, 2, 2],
      [7, 5, 5, 10, 1, 13, 1, 14, 5, 17, 5, 12, 1, 13, 1, 9, 5, 5, 8],
      [6, 1, 1, 1, 1, 1, 1, 1, 1, 6, 1, 1, 1, 1, 1, 1, 1, 1, 6],
      [6, 1, 14, 8, 1, 14, 5, 12, 1, 13, 1, 14, 5, 12, 1, 7, 12, 1, 6],
      [6, 4, 1, 6, 1, 1, 1, 1, 1, 1, 1, 1, 1, 1, 1, 6, 1, 4, 6],
      [16, 12, 1, 13, 1, 11, 1, 14, 5, 17, 5, 12, 1, 11, 1, 13, 1, 14, 18],
      [6, 1, 1, 1, 1, 6, 1, 1, 1, 6, 1, 1, 1, 6, 1, 1, 1, 1, 6],
      [6, 1, 14, 5, 5, 15, 5, 12, 1, 13, 1, 14, 5, 15, 5, 5, 12, 1, 6],
      [6, 1, 1, 1, 1, 1, 1, 1, 1, 1, 1, 1, 1, 1, 1, 1, 1, 1, 6],
      [9, 5, 5, 5, 5, 5, 5, 5, 5, 5, 5, 5, 5, 5, 5, 5, 5, 5, 10]
    ],
    "ghosts": [
      {
        "img": ""
      },
      {
        "img": "./assets/ghosts/1/ghost.png"
      }
    ]
  },
  {
    "BG-Music": "assets/audio/bg-music/Donna-Summer-Hard-for-the-Money",
    "map": [
      [7, 5, 5, 5, 5, 5, 5, 5, 5, 17, 5, 5, 5, 5, 5, 5, 5, 5, 8],
      [6, 1, 1, 1, 1, 1, 1, 1, 1, 6, 1, 1, 1, 1, 1, 1, 1, 1, 6],
      [6, 4, 7, 8, 1, 7, 5, 8, 1, 6, 1, 7, 5, 8, 1, 7, 8, 4, 6],
      [6, 1, 9, 10, 1, 9, 5, 10, 1, 13, 1, 9, 5, 10, 1, 9, 10, 1, 6],
      [6, 1, 1, 1, 1, 1, 1, 1, 1, 1, 1, 1, 1, 1, 1, 1, 1, 1, 6],
      [6, 1, 14, 12, 1, 11, 1, 14, 5, 17, 5, 12, 1, 11, 1, 14, 12, 1, 6],
      [6, 1, 1, 1, 1, 6, 1, 1, 1, 6, 1, 1, 1, 6, 1, 1, 1, 1, 6],
      [9, 5, 5, 8, 1, 16, 5, 12, 1, 13, 1, 14, 5, 18, 1, 7, 5, 5, 10],
      [2, 2, 2, 6, 1, 6, 1, 1, 1, 1, 1, 1, 1, 6, 1, 6, 2, 2, 2],
      [5, 5, 5, 10, 1, 13, 1, 7, 12, 3, 14, 8, 1, 13, 1, 9, 5, 5, 5],
      [2, 2, 2, 2, 1, 1, 1, 6, 3, 3, 3, 6, 1, 1, 1, 2, 2, 2, 2],
      [5, 5, 5, 8, 1, 11, 1, 9, 5, 5, 5, 10, 1, 11, 1, 7, 5, 5, 5],
      [2, 2, 2, 6, 1, 6, 1, 1, 1, 2, 1, 1, 1, 6, 1, 6, 2, 2, 2],
      [7, 5, 5, 10, 1, 13, 1, 14, 5, 17, 5, 12, 1, 13, 1, 9, 5, 5, 8],
      [6, 1, 1, 1, 1, 1, 1, 1, 1, 6, 1, 1, 1, 1, 1, 1, 1, 1, 6],
      [6, 1, 14, 8, 1, 14, 5, 12, 1, 13, 1, 14, 5, 12, 1, 7, 12, 1, 6],
      [6, 4, 1, 6, 1, 1, 1, 1, 1, 1, 1, 1, 1, 1, 1, 6, 1, 4, 6],
      [16, 12, 1, 13, 1, 11, 1, 14, 5, 17, 5, 12, 1, 11, 1, 13, 1, 14, 18],
      [6, 1, 1, 1, 1, 6, 1, 1, 1, 6, 1, 1, 1, 6, 1, 1, 1, 1, 6],
      [6, 1, 14, 5, 5, 15, 5, 12, 1, 13, 1, 14, 5, 15, 5, 5, 12, 1, 6],
      [6, 1, 1, 1, 1, 1, 1, 1, 1, 1, 1, 1, 1, 1, 1, 1, 1, 1, 6],
      [9, 5, 5, 5, 5, 5, 5, 5, 5, 5, 5, 5, 5, 5, 5, 5, 5, 5, 10]
    ],
    "ghosts": [
      {
        "img": ""
      },
      {
        "img": "./assets/ghosts/1/ghost.png"
      }
    ]
  },
  {
    "BG-Music": "assets/audio/bg-music/Kenny-Rogers-Gambler",
    "map": [
      [7, 5, 5, 5, 5, 5, 5, 5, 5, 17, 5, 5, 5, 5, 5, 5, 5, 5, 8],
      [6, 1, 1, 1, 1, 1, 1, 1, 1, 6, 1, 1, 1, 1, 1, 1, 1, 1, 6],
      [6, 4, 7, 8, 1, 7, 5, 8, 1, 6, 1, 7, 5, 8, 1, 7, 8, 4, 6],
      [6, 1, 9, 10, 1, 9, 5, 10, 1, 13, 1, 9, 5, 10, 1, 9, 10, 1, 6],
      [6, 1, 1, 1, 1, 1, 1, 1, 1, 1, 1, 1, 1, 1, 1, 1, 1, 1, 6],
      [6, 1, 14, 12, 1, 11, 1, 14, 5, 17, 5, 12, 1, 11, 1, 14, 12, 1, 6],
      [6, 1, 1, 1, 1, 6, 1, 1, 1, 6, 1, 1, 1, 6, 1, 1, 1, 1, 6],
      [9, 5, 5, 8, 1, 16, 5, 12, 1, 13, 1, 14, 5, 18, 1, 7, 5, 5, 10],
      [2, 2, 2, 6, 1, 6, 1, 1, 1, 1, 1, 1, 1, 6, 1, 6, 2, 2, 2],
      [5, 5, 5, 10, 1, 13, 1, 7, 12, 3, 14, 8, 1, 13, 1, 9, 5, 5, 5],
      [2, 2, 2, 2, 1, 1, 1, 6, 3, 3, 3, 6, 1, 1, 1, 2, 2, 2, 2],
      [5, 5, 5, 8, 1, 11, 1, 9, 5, 5, 5, 10, 1, 11, 1, 7, 5, 5, 5],
      [2, 2, 2, 6, 1, 6, 1, 1, 1, 2, 1, 1, 1, 6, 1, 6, 2, 2, 2],
      [7, 5, 5, 10, 1, 13, 1, 14, 5, 17, 5, 12, 1, 13, 1, 9, 5, 5, 8],
      [6, 1, 1, 1, 1, 1, 1, 1, 1, 6, 1, 1, 1, 1, 1, 1, 1, 1, 6],
      [6, 1, 14, 8, 1, 14, 5, 12, 1, 13, 1, 14, 5, 12, 1, 7, 12, 1, 6],
      [6, 4, 1, 6, 1, 1, 1, 1, 1, 1, 1, 1, 1, 1, 1, 6, 1, 4, 6],
      [16, 12, 1, 13, 1, 11, 1, 14, 5, 17, 5, 12, 1, 11, 1, 13, 1, 14, 18],
      [6, 1, 1, 1, 1, 6, 1, 1, 1, 6, 1, 1, 1, 6, 1, 1, 1, 1, 6],
      [6, 1, 14, 5, 5, 15, 5, 12, 1, 13, 1, 14, 5, 15, 5, 5, 12, 1, 6],
      [6, 1, 1, 1, 1, 1, 1, 1, 1, 1, 1, 1, 1, 1, 1, 1, 1, 1, 6],
      [9, 5, 5, 5, 5, 5, 5, 5, 5, 5, 5, 5, 5, 5, 5, 5, 5, 5, 10]
    ],
    "ghosts": [
      {
        "img": ""
      },
      {
        "img": "./assets/ghosts/1/ghost.png"
      }
    ]
  }
]
